- Lupe Gonzalez - VP Customer Experience **
- Connor Fitzgerald - Biz Development **
- Ryan Le - Growth, Data, and Analytics **
- Charles Kim - Data Engineer **
- Brooke Flanagan - Business Development **
- Jeff Martineau - Executive Assistant **
- Noelle Miraglia - Executive Assistant **
- Etienne Lawlow - Android Dev **
- Nicholas Yoon - IOS Engineer **
- Shaun Panjabi - Software Engineer**
- Ashok Bania - Product Management **
- Jeffrey Hwang - Senior Product Manager **
- Jeremy Fourteau - Product @ Headspace
- Gary Jense - Senior Product Manager
- Andrea Hume - ? @ Headspace
- Ryan Tabura - User Insights Analyst
- Francois Chartrand - Senior Product Designer
- Joe Ritchey - Agile Coach


Alex Pompliano - Editor
Natascha Picard - Product Designer
Adam Diehl - Lead Product Designer

Anna Charity - Head of Design
Ken Seeno - Product Designer
Alex Wells - QA Engineer
Michael Marchand - Corporate Counsel
Joe Powers - Managing Director of Healthcare

Samantha Hunter - Technical Producer
Nina Ligon - Design Research and Strategy

Ryan Kelly - International Program Manager

Joseph Reed - Product Support Specialist
Courtney Osborne - Senior Accountant
Nathan Moorman - Senior Writer
